18 15
1 11
3 4 2 9 4 9 9 3 2 4 3 9 4 2 9 3 4 9
3 1 1 1 1 1 3 4 0 0 0 0 3 8 2 9 3 9
4 1 1 0 0 0 0 0 0 0 1 1 3 9 0 1 2 3
9 4 1 0 0 1 1 4 0 0 3 4 9 1 0 1 0 3
9 2 3 8 0 2 4 3 0 0 2 8 1 0 0 0 0 7
8 3 4 9 0 2 3 0 0 0 0 0 0 0 1 1 0 8
3 1 1 0 0 0 0 1 4 0 4 3 9 2 3 4 0 2
5 1 0 0 0 1 0 1 2 0 7 4 9 3 2 9 0 3
7 3 2 0 0 0 2 4 9 0 0 0 0 0 0 0 0 4
8 3 6 0 0 0 2 9 3 2 0 0 1 4 0 0 1 3
5 0 0 0 0 0 1 6 8 2 0 0 3 9 2 0 0 3
3 0 0 0 0 0 1 3 2 9 0 0 2 9 3 0 0 3
2 9 3 0 0 0 0 0 0 0 0 0 0 0 0 0 0 4
9 4 1 1 8 4 7 1 1 1 0 0 0 1 1 7 4 9
2 9 3 3 9 9 4 2 9 3 4 5 9 4 3 2 9 4