23 15
9 1
2 3 9 7 8 9 4 6 3 2 9 7 4 6 9 3 3 9 8 2 9 9 3
8 2 0 1 4 3 4 2 3 0 1 2 3 4 2 3 3 7 8 6 7 8 3
8 1 0 0 0 1 1 4 2 0 0 2 2 3 2 3 9 9 8 6 7 8 3
9 1 0 1 0 0 0 1 0 0 0 1 1 9 9 4 2 9 3 3 2 9 3
9 1 0 1 0 0 1 0 2 0 0 0 1 9 1 1 1 2 7 2 3 9 2
2 9 0 0 0 3 4 9 2 0 0 9 2 3 1 0 0 3 9 2 7 3 4
2 1 0 0 0 0 0 3 4 0 0 1 1 0 0 0 0 1 1 2 3 9 4
2 1 0 0 0 0 0 4 5 0 0 9 7 2 1 0 0 0 0 0 0 0 3
3 0 0 0 0 0 0 7 4 0 0 9 9 7 1 1 1 9 4 2 3 0 2
3 3 9 0 0 1 1 0 0 0 0 0 1 9 3 4 2 7 3 2 4 0 3
2 9 9 0 0 1 1 0 0 0 0 0 0 0 0 1 1 0 0 1 0 0 2
2 9 3 0 0 0 0 0 0 0 0 3 8 2 9 1 0 0 1 0 0 0 7
7 3 1 1 0 0 0 0 0 1 1 7 3 9 4 1 0 0 0 1 0 2 6
3 5 1 1 1 1 0 3 2 9 9 3 2 9 6 8 1 1 1 7 3 9 4
2 3 9 4 3 8 2 3 9 4 8 6 7 3 2 9 4 2 9 3 8 2 9