20 18
1 8
2 3 4 9 9 3 4 4 2 3 2 9 4 4 3 9 2 2 9 3
2 4 3 9 9 0 0 0 1 0 1 0 0 1 1 3 4 3 9 9
9 9 2 0 0 0 1 0 0 0 0 0 1 1 1 0 0 0 1 2
9 7 4 1 0 0 1 0 9 5 0 0 2 4 0 0 0 1 0 3
7 7 4 1 0 0 1 4 9 5 0 0 2 4 4 0 0 1 0 9
9 7 4 1 0 2 4 2 9 1 0 0 1 4 5 4 4 1 0 6
9 4 4 1 0 4 9 2 1 0 0 0 0 1 5 4 3 7 0 8
9 7 4 1 0 4 3 1 0 0 0 0 0 0 1 4 4 1 0 3
3 1 0 0 1 1 0 0 1 0 0 1 0 0 0 1 0 0 1 7
3 1 0 0 0 0 0 1 0 0 0 1 1 0 0 0 0 0 1 7
9 7 4 1 0 4 3 1 0 0 0 0 0 0 1 4 4 1 0 3
9 4 4 1 0 4 9 2 1 0 0 0 0 1 5 4 3 7 0 8
9 7 4 1 0 2 4 2 9 1 0 0 1 4 5 4 4 1 0 6
7 7 4 1 0 0 1 4 9 5 0 0 2 4 4 0 0 1 0 9
9 7 4 1 0 0 1 0 9 5 0 0 2 4 0 0 0 1 0 3
9 9 2 0 0 0 1 0 0 0 0 0 1 1 1 0 0 0 1 2
2 4 3 9 9 0 0 0 1 0 1 0 0 1 1 3 4 3 9 9
2 3 4 9 9 3 4 4 2 3 2 9 4 4 3 9 2 2 9 3